~~~~~~~~~~~~~
~...........~
~.=.........~
~...........~
~...........~
~...........~
~~~~~~~~~~~~~
