~~~~~~~~~~~~~
~.=...=...=.~
~.=.=.=.=.=.~
~.=.=.=.=.=.~
~.=.=.=.=.=.~
~...=...=...~
~~~~~~~~~~~~~
